[
	"111111111111111",
	"100200000000001",
	"111111110011111",
	"100000010010001",
	"100000010010001",
	"100011110010001",
	"100000000000001",
	"100000000000001",
	"100000000000001",
	"100100100000001",
	"100100100000001",
	"100100100000001",
	"100100111111111",
	"100100000000031",
	"111111111111111"
]